9.ox
oo..oo.o.o
oo..ooo...
.oo.oo.ooo
...o.o.o..
..oo.o....
.o.o.ooo.o
..o.o...o.
.o.oo.o.oo
ooo...ooo.
